111111111111
1P0000000001
100101010101
100100000001
101010101001
100000C00001
101010001101
100000000C01
101010101001
1000000000E1
111111111111