11111111
1P0000E1
10101001
100000C1
10101001
10000001
1C010101
1C010101
11111111