1111111111111111
1000000000000011
1001010101010001
1001000000010101
1010101000000001
1000000000010101
101010000101P001
1C00000000C00011
101001010101E101
1111111111111111
1111111111111111
1111111111111101
1111111111111101
1111111111111101
1111111111111101
1111111111111111
1111111111111111